=+=+=+=+=+=+=+=+=+=+=+=+=+
+=+=+=+=__________+=+=+=+=
=+=+=+=/|        /|+=+=+=+
+=+=+=/_|______ / |=+=+=+=
=+=+=+| |      |  |+=+=+=+
+=+=+=| |______|__|=+=+=+=
=+=+=+|/       | /=+=+=+=+
+=+=+=/________|/=+=+=+=+=
=+=+=+=+=+=+=+=+=+=+=+=+=+